##########
#00000000#
#00###000#
#00000000#
#0000#000#
#0000#000#
#00###000#
#0000#000#
#0000#000#
##########